11111111111
1 1 1 1 1 1
11111111111
1 1       1
111     3 1
1 1       1
111       1
1     1   1
1     1   1
1     1 8 1
1     1   1
1     11111
1     1 1 1
1     11111
1     1 1 1
11111111111
2
11111111111
1    1    1
1    1  3 1
1         1
1         1
1         1
1    1    1
1   111   1
1    1    1
1    1    1
1    1    1
1    1    1
1    1    1
1    1  8 1
1    1    1
11111111111
3
11111111111
1         1
1       3 1
1         1
1   1     1
1   1  1111
1   1  1 81
1   1  1  1
1   1  1  1
1   1  1  1
1   1  1  1
1   1  1  1
1   1     1
1   1     1
1   1     1
11111111111
4
11111111111
1         1
1    5    1
1         1
1    1    1
1    1    1
1    1  8 1
1    111111
1         1
1         1
1         1
1111111 5 1
1         1
1         1
1         1
11111111111
5
11111111111
1   1     1
1    11   1
1         1
1         1
1 6  11   1
1   1     1
11   1    1
1 1  1    1
1 1  1  8 1
11    1   1
1      1111
1       1 1
1        11
1         1
11111111111
6
11111111111
1         1
1  8    5 1
1         1
16        1
166       1
1666      1
16666     1
16666     1
1666      1
166       1
16       61
1       661
1      6661
1     66661
11111111111


7
11111111111
1         1
1         1
1  11111111
1    1    1
1    1    1
1    1 8  1
11  11    1
1    11  11
1    1    1
1    1    1
1    14   1
11111111  1
1         1
1        31
11111111111
8
11111111111
1  1      1
1111      1
1  1      1
1111      1
1     1   1
1     1   1
1  8  1   1
1     1   1
1  4  1   1
1111111   1
1         1
1         1
1         1
1         1
11111111111
9
11111111111
1         1
1  8      1
1         1
1166611   1
1     1   1
1     1   1
1     1   1
1  5  1   1
1     1   1
1     1   1
1166611   1
1         1
1         1
1         1
11111111111