11111111111
1    1    1
1 3  1    1
1         1
1         1
1         1
1 8  1    1
1    1    1
111111    1
1         1
1         1
1    111111
1         1
1         1
1         1
11111111111
2
11111111111
1     1   1
1     1 8 1
1     1   1
1  1111   1
1     1   1
1     1  11
1     1   1
1  1111  31
1     1   1
1     1  11
1     1   1
1     1   1
1   111   1
1   1 1   1
11111111111
3
11111111111
1         1
1  8      1
1  11111111
1         1
1         1
1         1
1111111   1
1         1
1         1
1         1
1    111111
1         1
1         1
1        31
11111111111
4
11111111111
1         1
1         1
1   111   1
1   1 1   1
1  11 11  1
1  1   1  1
1 5     5 1
1 5     5 1
1  1 8 1  1
1  11 11  1
1   1 1   1
1   111   1
1         1
1         1
11111111111
5
11111111111
1         1
1 8       1
1         1
1         1
1666111   1
1   1 1 5 1
1   111   1
1   111   1
1 5 1 1   1
1   1116661
1         1
1         1
1         1
1         1
11111111111
6
11111111111
1         1
1         1
1         1
1 55 1    1
1    1    1
1    1    1
1    6    1
1    6    1
1    6    1
1    1    1
1    1    1
1    1    1
1 8  1    1
1    1    1
11111111111
7
11111111111
1         1
1 111 111 1
1         1
1 8       1
1     1   1
1 111 1   1
1     3   1
1   1 1   1
1 4 1 1   1
1   1 1   1
1         1
1   111   1
1         1
1         1
11111111111
8
11111111111
1   1 1   1
1    1    1
1         1
1 5       1
1      1  1
1     1   1
1    1    1
1   1     1
1    1    1
1     1   1
1  1 1    1
1   1     1
1    1    1
1 8   1   1
11111111111
9
11111111111
1         1
1   55555 1
1         1
1  1111  11
1     1   1
1     1   1
1     1 8 1
1     1   1
1     1   1
1     1   1
111  111111 
1         1
1 55555   1
1         1
11111111111