11111111111
1         1
1         1
1         1
111111    1
1         1
1         1
1         1
1   1111111
1   1 1 1 1
1   1111111
1   1     1
1       3 1
1       8 1
1         1
11111111111
2
11111111111
1     1   1
1     1   1
1     1   1
1  1111   1
1     1   1
1   3 1  11
1     1   1
1  1111   1
1     1   1
1     1  11
1     1   1
1     1   1
1 8 111   1
1   1 1   1
11111111111
3
11111111111
1   13    1
1   1   8 1
1   1     1
1   1  11 1
1   1   111
1   1   1 1
1   1   111
1   1   1 1
1   1   111
1   1   1 1
1   1   111
1       1 1
1       111
1       1 1
11111111111
4
11111111111
1   1 1 8 1
1   111   1
1   1 1   1
1   111   1
1 5 1 1   1
1   1116661
1   1 1   1
1   111 5 1
1   1 1   1
1   111   1
1         1
1    6    1
1         1
1         1
11111111111
5
11111111111
1         1
1         1
1         1
1         1
1666111   1
1   1 1 5 1
1   111   1
1   111   1
1 5 1 1   1
1   1116661
1         1
1         1
1       8 1
1         1
11111111111
6
11111111111
1   6     1
1      5  1
1   6     1
11111166611
1    1    1
1    1    1
1    1  8 1
1    1    1
1    111111
1    6    1
1   6     1
1  6      1
1 6       1
16        1
11111111111
7
11111111111
1       1 1
1       111
1         1
1         1
11111     1
1   1     1
1 8 1     1
1   111   1
1         1
1         1
1   11    1
1   1     1
11111 3   1
1 1 1     1
11111111111
8
11111111111
1         1
1      5  1
1         1
1111      1
1         1
1         1
1   1111111
1   1111111
1         1
1         1
11111     1
1  66     1
18 66  5  1
1  66     1
11111111111
9
11111111111
1    1  8 1
1    6    1
1    1    1
1    6    1
1    1    1
1    6    1
1    1    1
1    6    1
1    1    1
1    6    1
1    1    1
1    6    1
1    6    1
1    1    1
11111111111