11111111111
111     111
1         1
1         1
1    1    1
1    111111
1        31
1         1
1         1
111111    1
1    1    1
1 8 111   1
1    1    1
1         1
11       11
11111111111
2
11111111111
1         1
1         1
11   1    1
1   11    1
1    131111
1 8  111  1
1   111   1
1 1111    1
111  1    1
1 1  11   1
111111    1
1    1    1
1         1
1         1
11111111111
3
11111111111
1 1       1
1 1 111   1
1 1       1
1 1 111   1
1 1       1
1   111   1
1 8       1
1   111   1
1         1
1   111   1
1         1
1         1
1 3       1
1   111   1
11111111111
4
11111111111
11        1
1         1
11       11
1 1     1 1
1  1   1  1
1  66666  1
1         1
1    5    1
1         1
1  66666  1
1  1   1  1
1 1     1 1
11       11
1       8 1
11111111111
5
11111111111
1         1
1         1
1         1
111  111661
1 1 51 1  1
1 1  1 1  1
1 1661 1  1
1 1  1 1  1
1 1  1 1  1
111  111  1
1         1
18    5   1
11111111111
1         1
11111111111
6
11111111111
1         1
1         1
1         1
1       5 1
166111    1
1    1    1
1   81    1
1    1    1
1    1    1
1    1    1
1    1    1
1         1
1    5    1
1         1
11111111111
7
11111111111
1         1
1         1
1  11111111
1    1    1
1    1    1
1    1    1
11  11    1
1    11  11
1  8 1    1
1    1    1
1    1    1
11111111  1
1         1
1         1
11111111111
8
11111111111
1         1
1         1
1         1
1         1
1  11111  1
1         1
1         1
1    1    1
1    1    1
1    111111
1    166661
1     66661
1 5   66861
1     66661
11111111111
9
11111111111
1 8  1    1
1    1    1
1   1 1   1
1  1 6 1  1
1   1 1   1
1    1    1
1   1 1   1
1  1 6 1  1
1   1 1   1
1    1    1
1         1
1         1
1    1    1
1   1 1   1
11111111111