11111111111
1 8   1   1
1     1   1
1     1   1
1111      1
1  1      1
1  11111  1
1         1
1         1
1  11111  1
1  1      1
1111      1
1     1   1
1     1 3 1
1     1   1
11111111111
2
11111111111
1     1   1
1     1 3 1
1     1   1
1111      1
1  1      1
1  11111  1
1         1
1         1
1  11111  1
1  1      1
1111      1
1     1   1
1     1   1
1 8   1   1
11111111111
3
11111111111
1         1
1         1
1         1
1   111   1
1    1    1
1    1  8 1
1   111   1
1   111   1
1    1  3 1
1    1    1
1   111   1
1    1    1
1         1
111     111
11111111111
4
11111111111
1 1     1 1
1 1     1 1
1 1     1 1
1 1  5  1 1
111     111
1         1
1         1
1         1
11166666111
16666666661
16666666661
1         1
1  8      1
1         1
11111111111
5
11111111111
1         1
1  8      1
1         1
111111    1
1    1    1
1    1    1
1    1    1
1    1    1
1 55 1 55 1
1    1    1
1         1
1         1
1    5    1
1         1
11111111111
6
11111111111
1   6     1
1      5  1
1   6     1
11111166611
1    1    1
1    1    1
1    1    1
1    1    1
1    111111
1    6    1
1   6     1
1  6      1
1 6     8 1
16        1
11111111111


7
11111111111
1         1
1       8 1
1         1
1  11   111
16611   1 1
16611   1 1
1  11   111
1   1   111
1   1   1 1
1   1   1 1
1       111
1       1 1
11111111111
1 1 1 1 1 1
11111111111
8
11111111111
1         1
1 8       1
11        1
1 1       1
1  1     61
1   1   6 1
1    1 6  1
1     1   1
1         1
1        11
1       1 1
1      1  1
1     1 6 1
1    1   61
11111111111
9
11111111111
1         1
1         1
1666      1
1  1      1
1  11111551
1  1      1
1  1  8   1
1  1      1
1  11111551
1  1      1
1666      1
1         1
1         1
11  111  11
11111111111