11111111111
1 1 1 1 1 1
11 1     11
1 1    8  1
1         1
1     11111
11    1   1
1 1   1   1
11    1   1
1     1   1
1         1
11       11
1 1     1 1
11 1 3 1 11
1 1 1 1 1 1
11111111111
2
11111111111
1         1
1         1
11   1    1
1   11    1
1    1 1111
1    111 31
1   111   1
1 1111    1
111  1    1
1 1  11   1
111111    1
1    1    1
1  8      1
1         1
11111111111
3
11111111111
1  11111  1
1 8 111   1
1         1
1         1
1    1111 1
1    1    1
1    1    1
1    1    1
1    1    1
1  111    1
1         1
1         1
1   111 3 1
1  11111  1
11111111111
4
11111111111
1         1
1         1
1  11111  1
1    1    1
1    1    1
111  1  111
1    1    1
1 8  1    1
1    1    1
1    1    1
11111111111
1 6 6 6 6 1
16 6 6 6 61
1 6 6 6 6 1
11111111111
5
11111111111
1         1
1 1     8 1
1 6       1
1 1    6161
1 6    1  1
1 1    6  1
1 6    1  1
1 1    6  1
1 6    1  1
1 1    6  1
1 6 55 1  1
1 1       1
1 6       1
1 1       1
11111111111
6
11111111111
18     6 61
1       6 1
111    6 61
1      1111
1    111  1
1  111    1
1  1      1
1  1      1
1  1      1
1  1      1
1  11111  1
1         1
1         1
11  111  11
11111111111



7
11111111111
1         1
1      8  1
1   1 1 1 1
1    3 4  1
1   1     1
1         1
1   1     1
1         1
1   1     1
1         1
1   1 1  11
1         1
1         1
1         1
11111111111
8
11111111111
1         1
1         1
1     1   1
1     1   1
1     1   1
1    1    1
1    1    1
1      1  1
1       111
11111     1
11    1   1
111   81  1
11        1
1         1
11111111111
9
11111111111
1         1
1  11  11 1
1 1111 11 1
1  11     1
1         1
1         1
1   1     1
1  111    1
1   1     1
1     11  1
1    1111 1
1     11  1
1      8  1
1         1
11111111111